%%%%%%%%%%%%%%%%%%%%
%    %   o    %    %
% %% %.%%%%%%.% %% %
% %   .      .   % %
% % %% %%  %% %% % %
%      %G  G%      %
% % %% %%%%%% %% % %
% %              % %
% %% % %%%%%% % %% %
%    %   P    %    %
%%%%%%%%%%%%%%%%%%%%
