%%%%%%%%%%%%%%%%%%%%%
%    %    o    %    %
% %% % %%%%%%% % %% %
%  %                %
%% % %% %%%%% %% % %%
%  %             %  %
%% %%%%%%%G%% %%%% %%
%%      %GGG%      %%
%% %%%% %%%%%%%%%% %%
%  %             %  %
%% % % % %%% % % % %%
%    % %     % %    %
% %% %   %%%   % %% %
% %% %%% %%% %%%%%% %
%         P         %
%%%%%%%%%%%%%%%%%%%%%