%%%%%%%%%%%%%%%%%%%%%
%    %    o    %    %
% %% % %%%%%%% % %% %
%                   %
%% % %% %%%%% %% % %%
%  %             %  %
%% %%%% %%G%% %%%% %%
%%     .%GGG%      %%
%% %%%% %%%%% %%%% %%
%  %             %  %
%% % % % %%% % % % %%
%    % %     % %    %
% %% %   %%%   % %% %
% %% %%% %%% %%% %% %
%         P         %
%%%%%%%%%%%%%%%%%%%%%