%%%%%%%%%%%%%%%%%%%%%
%    %    o    %    %
% %% % %%%%%%% % %% %
%  %                %
%% % %% %%%%% %% % %%
%  %             %  %
%% %%%%%%%G%% %%%% %%
%%     .%GGG%      %%
%% %%%% %%%%% %%%% %%
%  %             %  %
%% % % % %%% % % % %%
%    % %     % %    %
% %% %   %%%   % %% %
% %% %%% %%% %%% %% %
%         P         %
%%%%%%%%%%%%%%%%%%%%%