%%%%%%%%%%%%%%%%%%%%%
%....%.... ....%....%
%o%%.%.%%%%%%%.%.%%o%
%......... .........%
%%.%.%%.%%%%%.%%.%.%%
%..%.............%..%
%%.%%%%.%%G%%.%%%%.%%
%%......%GGG%......%%
%%.%%%%.%%%%%.%%%%.%%
%..%......P......%..%
%%.%.%.%.%%%.%.%.%.%%
%....%.%.. ..%.%....%
%.%%.%...%%%...%.%%.%
%o%%.%%%.%%%.%%%.%%o%
%......... .........%
%%%%%%%%%%%%%%%%%%%%%