%%%%%%%%%%%%%%%%%%%%
%      %G  G%      %
% %%   %%  %%   %% %
%P%  %        %  %o%
% %% % %%%%%% % %% %
%                  %
%%%%%%%%%%%%%%%%%%%%
