%%%%%%%%%%%%%%%%%%%%
%      %G  G%  ... %
% %%   %%  %%   %% %
%P%  %        %  %o%
% %% % %%%%%% % %% %
%              ... %
%%%%%%%%%%%%%%%%%%%%
