%%%%%%%%%%%%%%%%%%%%
% ..   %G  G%  ... %
% %%   %%  %%   %% %
%P%  % ...    %  %o%
% %% % %%%%%% % %% %
% ..   ...     ... %
%%%%%%%%%%%%%%%%%%%%
